2.............................
2.............................
2...2.........................
22222.........................
..............................
..............................
.............................2
............................22
.....22222.................22.
.........................222..
..............................
.....................22222....
..............................
..............................
..............................
..............................
